GMTEACH1
An Interactive Fiction by GLUE-AI
Release 1 / Serial number 140120 / Inform 7 build 6G60 (I6/v6.32 lib 6/12N) SD

Desk
You are at the far end of a musical scale that you cant quite remember. A recent boy-band rise to fame prevents all further hopes of remembering any performance  other than their smash hit that is strangely reminiscent of the flight of the bumblebees.  A large Grumpy music teacher to the east emits a faint green light.  Type "test me" to win fast! 

A musician seems to have left his book of music performances lying out in plain view!

You can also see a large Grumpy music teacher and a big colorfull midi device here.

Q

>look
Desk
You are at the far end of a musical scale that you cant quite remember. A recent boy-band rise to fame prevents all further hopes of remembering any tune  other than their smash hit that is strangely reminiscent of the flight of the bumblebees.  A large Grumpy music teacher to the east emits a faint green light.  Type "test me" to win fast! 

The wizard seems to have left his book of magic spells lying out in plain view!

You can also see a large Grumpy music teacher and a big round beach ball here.

Q

>look at grumpy
He looks glumly back. There's still a purple-ish bruise on his cheekbone from the disaster Thursday afternoon.

Q

>look at ball
Big and round and bright red and yellow.

Q

>test me
(Testing.)

>[1] x hand
It is the same green hand that has Inscribed in on the blackboard of the the words remember the scala of Sinbads Theme  to find your way forward."

Q>[2] push hand
There is an aura of magic about the large grumpity hand that prevents you doing this.  Perhaps name the notes of the musical bar: say egbdf
Q>[3] say egbdf
With an eerie musical scale, the hand falls to the side hearing songA
Q>[4] e

Small stage
A flight of steps leads down into the darkness.

>[5] d

Dance Floor
The Dance Floor is just the dance floor below the stage and west of the rest of the pub. An alien presence invades your mind and deep in your bones you hear a voice echo "Welcome brave soul. You have passed the first hurdle. Before you proceed, you must answer the following questions."

What is your name?

Enter your name >[6] peter
Welcome to this venture, peter

How old are you?

Please enter a number >[7] 34
Thank you: You are 34 for the remainder of your venture into the unknown

Do you want to play as a male, female or neutral character

Please enter M, F or N (Male or Female or Neuter) >[8] m
Thank you. You are Masculine gender

Which of the following is your preferred character type:
1 - Drummer
2 - Keyboardist
3 - Lipsyncer
4 - Other Faker

Please select a number between 1 and 4 >[9] 3
Thank you, you are playing as a Lipsyncer

You have chosen:
Name: peter
Age: 34
Sex: Masculine
Character: Lipsyncer

Are you happy with your responses?

Please enter Y or N (Yes or No) >[10] y
Thank you. Venture into the unknown brave Lipsyncer

* * *

>look
Desk
You are at the far end of a musical scale that you cant quite remember. A recent boy-band rise to fame prevents all further hopes of remembering any tune  other than their smash hit that is strangely reminiscent of the flight of the bumblebees.  A large Grumpy music teacher to the east emits a faint green light.  Type "test me" to win fast! 

The wizard seems to have left his book of magic spells lying out in plain view!

You can also see a large Grumpy music teacher and a big round beach ball here.

Q

>x ball
Big and round and bright red and yellow.

Q

>ball
Big and round and bright red and yellow.

Q

>look at ball
Big and round and bright red and yellow.

Q

>look at tea
>LOOK AT TEACHER
He looks glumly back. There's still a purple-ish bruise on his cheekbone from the disaster Thursday afternoon.

Q

>look at ba
You can't see any such thing.

>look at bal
>LOOK AT BALL
Big and round and bright red and yellow.

Q

* * *

>help
[Try typing LOOK for a description of your surroundings. Any directions indicate exits which you can use by typing EAST (or E). Some of the objects mentioned in the description might be worth a closer look with a command like EXAMINE BIG ROUND BEACH BALL. You can also TAKE or DROP some things, type INVENTORY to see a list of what you're carrying already, OPEN or CLOSE containers or doors, and so on.]

[To stop these messages entirely, type NOVICE OFF.
]

>look
Desk
You are at the far end of a musical scale that you cant quite remember. A recent boy-band rise to fame prevents all further hopes of remembering any tune  other than their smash hit that is strangely reminiscent of the flight of the bumblebees.  A large Grumpy music teacher to the east emits a faint green light.  Type "test me" to win fast! 

The wizard seems to have left his book of magic spells lying out in plain view!

You can also see a large Grumpy music teacher and a big round beach ball here.

Q

>verbs
That's not a verb I recognise.

>verb
That's not a verb I recognise.

>jump
You jump on the spot, fruitlessly.

Q

>e
(first opening the large hand)
There is an aura of magic about the large grumpity hand that prevents you doing this.  Perhaps name the notes of the musical bar: say egbdf
Q

>eat
(your beanscript)
He's plainly inedible.

Q

* * *

>unlock hand
There is an aura of magic about the large grumpity hand that prevents you doing this.  Perhaps name the notes of the musical bar: say egbdf
Q

I beg your pardon?

Q

I beg your pardon?

Q

>look
Desk
You are at the far end of a musical scale that you cant quite remember. A recent boy-band rise to fame prevents all further hopes of remembering any tune  other than their smash hit that is strangely reminiscent of the flight of the bumblebees.  A large Grumpy music teacher to the east emits a faint green light.  Type "test me" to win fast! 

The wizard seems to have left his book of magic spells lying out in plain view!

You can also see a large Grumpy music teacher and a big round beach ball here.

Q

>w
You can't go that way.

Q

* * *

>e
(first opening the large hand)
(first unlocking the large hand)
There is an aura of magic about the large grumpity hand that prevents you doing this.  Perhaps name the notes of the musical bar: say egbdf
Q

>Include Rewrite the Command Line by Ron Newcomb.
That's not a verb I recognise.

* * *

>fly
That's not a verb I recognise.

>think
What a good idea.

Q

>think it
I only understood you as far as wanting to think.

>ok
That's not a verb I recognise.

>think about it
I only understood you as far as wanting to think.

>think about it
I only understood you as far as wanting to think.

* * *

>look at t
You can't see any such thing.

>look at tea
>LOOK AT TEACHER
He looks glumly back. There's still a purple-ish bruise on his cheekbone from the disaster Thursday afternoon.

Q

* * *

>l
Desk
You are at the far end of a musical scale that you cant quite remember. A recent boy-band rise to fame prevents all further hopes of remembering any performance  other than their smash hit that is strangely reminiscent of the flight of the bumblebees.  A large Grumpy music teacher to the east emits a faint green light.  Type "test me" to win fast! 

A musician seems to have left his book of music performances lying out in plain view!

You can also see a large Grumpy music teacher and a big colorfull midi device here.

Q

>L
-- Created using Adventure Book for Inform 7 by Edward Griffiths
 Based on Adventure Book by Jon Ingold
 Command Summary:
 LOOK / L          Repeat the last page
 INVENTORY / I     Show player inventory
 SAVE / S          Save the game
 RESTORE / R       Restore the game
 QUIT / Q          Quit the game
 RESTART / X       Restart the game
 HELP / H          This text
 
 Select options by their number.  To use an object, type its name as it appears in the inventory list.

*** 1) Continue.

Q

>LOOK
-- Created using Adventure Book for Inform 7 by Edward Griffiths
 Based on Adventure Book by Jon Ingold
 Command Summary:
 LOOK / L          Repeat the last page
 INVENTORY / I     Show player inventory
 SAVE / S          Save the game
 RESTORE / R       Restore the game
 QUIT / Q          Quit the game
 RESTART / X       Restart the game
 HELP / H          This text
 
 Select options by their number.  To use an object, type its name as it appears in the inventory list.

*** 1) Continue.

Q

>LOOK
-- Created using Adventure Book for Inform 7 by Edward Griffiths
 Based on Adventure Book by Jon Ingold
 Command Summary:
 LOOK / L          Repeat the last page
 INVENTORY / I     Show player inventory
 SAVE / S          Save the game
 RESTORE / R       Restore the game
 QUIT / Q          Quit the game
 RESTART / X       Restart the game
 HELP / H          This text
 
 Select options by their number.  To use an object, type its name as it appears in the inventory list.

*** 1) Continue.

Q

>x
Are you sure you want to restart?

>y
GMTEACH
An Interactive Fiction by GLUE-AI
Release 1 / Serial number 140120 / Inform 7 build 6G60 (I6/v6.32 lib 6/12N) SD

-- Created using Adventure Book for Inform 7 by Edward Griffiths
 Based on Adventure Book by Jon Ingold
 Command Summary:
 LOOK / L          Repeat the last page
 INVENTORY / I     Show player inventory
 SAVE / S          Save the game
 RESTORE / R       Restore the game
 QUIT / Q          Quit the game
 RESTART / X       Restart the game
 HELP / H          This text
 
 Select options by their number.  To use an object, type its name as it appears in the inventory list.

*** 1) Continue.

Q

>i
You are carrying:
  your beanscript

Q

>l
-- Created using Adventure Book for Inform 7 by Edward Griffiths
 Based on Adventure Book by Jon Ingold
 Command Summary:
 LOOK / L          Repeat the last page
 INVENTORY / I     Show player inventory
 SAVE / S          Save the game
 RESTORE / R       Restore the game
 QUIT / Q          Quit the game
 RESTART / X       Restart the game
 HELP / H          This text
 
 Select options by their number.  To use an object, type its name as it appears in the inventory list.

*** 1) Continue.

Q

>LOOK
-- Created using Adventure Book for Inform 7 by Edward Griffiths
 Based on Adventure Book by Jon Ingold
 Command Summary:
 LOOK / L          Repeat the last page
 INVENTORY / I     Show player inventory
 SAVE / S          Save the game
 RESTORE / R       Restore the game
 QUIT / Q          Quit the game
 RESTART / X       Restart the game
 HELP / H          This text
 
 Select options by their number.  To use an object, type its name as it appears in the inventory list.

*** 1) Continue.

Q

>1
Q

>2
Q

>l
Q

>1
Q

>1
Q

>s
Save failed.

* * *

>l
Desk
You are at the far end of a musical scale that you cant quite remember. A recent boy-band rise to fame prevents all further hopes of remembering any performance  other than their smash hit that is strangely reminiscent of the flight of the bumblebees.  A large Grumpy music teacher to the east emits a faint green light.  Type "test me" to win fast! 

A musician seems to have left his book of music performances lying out in plain view!

You can also see a large Grumpy music teacher and a big colorfull midi device here.

Q

>w
You can't go that way.

From here, the only way out is to the east.

Q

>e
(first opening the large hand)
(first unlocking the large hand)
There is an aura of magic about the large grumpity hand that prevents you doing this.  Perhaps name the notes of the musical bar: say egbdf
Q

>d
You can't go that way.

From here, the only way out is to the east.

Q

>say egbdf
With an eerie musical scale, the hand falls to the side hearing songA
Q

>look
Desk
You are at the far end of a musical scale that you cant quite remember. A recent boy-band rise to fame prevents all further hopes of remembering any tune  other than their smash hit that is strangely reminiscent of the flight of the bumblebees.  A large Grumpy music teacher to the east emits a faint green light.  Type "test me" to win fast! 

The wizard seems to have left his book of magic spells lying out in plain view!

You can also see a large Grumpy music teacher and a big round beach ball here.

>e
Small stage
A flight of steps leads down into the darkness.

>d
Dance Floor
The Dance Floor is just the dance floor below the stage and west of the rest of the pub. An alien presence invades your mind and deep in your bones you hear a voice echo "Welcome brave soul. You have passed the first hurdle. Before you proceed, you must answer the following questions."

What is your name?

Enter your name

>test me
I think we will simply refer to you as test

How old are you?

Please enter a number

Please enter a number

Please enter a number

>quit
Please enter a number

>exit
Please enter a number

>1
It seems improbable that one of such tender years would be venturing so far.

Please enter a number

>1
It seems improbable that one of such tender years would be venturing so far.

Please enter a number

>2
It seems improbable that one of such tender years would be venturing so far.

Please enter a number

>7
Thank you: You are 7 for the remainder of your venture into the unknown

Do you want to play as a male, female or neutral character

Please enter M, F or N (Male or Female or Neuter)

Please enter M, F or N (Male or Female or Neuter)

Please enter M, F or N (Male or Female or Neuter)

>quit
Please enter M, F or N (Male or Female or Neuter)

* * *

>l
Desk
You are at the far end of a musical scale that you cant quite remember. A recent boy-band rise to fame prevents all further hopes of remembering any performance  other than their smash hit that is strangely reminiscent of the flight of the bumblebees.  A large Grumpy music teacher to the east emits a faint green light.  Type "test me" to win fast! 

A musician seems to have left his book of music performances lying out in plain view!

You can also see a large Grumpy music teacher and a big colorfull midi device here.

Q

>performances
You are the master of the following performances:
nifty:   The nifty performance causes objects to light up.

>play nifty on midi
The device bounces several times and then comes to rest.

Q

>play nifty on midi
The device bounces several times and then comes to rest.

Q

>play frotz on midi
I'm not quite sure what you meant by that.

Q

>frotz
I'm not quite sure what you meant by that.

Q

>nitfol
I'm not quite sure what you meant by that.

Q

>play nitfol
I'm not quite sure what you meant by that.

Q

>play nitfol on mini
You can't see any such thing.

>play nitfol on midi
I'm not quite sure what you meant by that.

Q

>play nitfol on device
I'm not quite sure what you meant by that.

Q

>play nitfol at device
I didn't understand that sentence.

>play nitfol on device
I'm not quite sure what you meant by that.

Q

>test learning
(Testing.)

>[1] performances
You are the master of the following performances:
nifty:   The nifty performance causes objects to light up.

>[2] look up nitfol in book
You find the page in the book that describes the nitfol performance, and commit the performance to memory.

Q>[3] performances
You are the master of the following performances:
nifty:   The nifty performance causes objects to light up.
nitfol:   The nitfol performance does something completely different.

>[4] nitfol
You play the nitfol performance, but nothing happens.

Q>[5] nitfol the device
You play nitfol on the big colorfull midi device, but nothing happens.

Q

>performances
You are the master of the following performances:
nifty:   The nifty performance causes objects to light up.
nitfol:   The nitfol performance does something completely different.

>nitfol
You play the nitfol performance, but nothing happens.

Q

>nitfol on midi
That's neither a verb I recognise nor a keyword you can use right now.

>nitfol on device
That's neither a verb I recognise nor a keyword you can use right now.

>play nitfol on device
You play nitfol on the big colorfull midi device, but nothing happens.

Q

>learn frotz from book
You find the page in the book that describes the frotz performance, and commit the performance to memory.

Q

>performances
You are the master of the following performances:
nifty:   The nifty performance causes objects to light up.
frotz:   The frotz performance causes spherical objects to quiver.
nitfol:   The nitfol performance does something completely different.

>play frotz on device
The device bounces several times and then comes to rest.

Q

* * *

>w
You can't go that way.

From here, the only way out is to the east.

Q

* * *

>e
(first opening the large hand)
(first unlocking the large hand)
There is an aura of magic about the large grumpity hand that prevents you doing this.  Perhaps name the notes of the musical bar: say egbdf
Q

>jump
Jumping would have no effect, or that's not the way to do so.

Q

>foo
That's neither a verb I recognise nor a keyword you can use right now.

>look
Desk
You are at the far end of a musical scale that you cant quite remember. A recent boy-band rise to fame prevents all further hopes of remembering any tune  other than their smash hit that is strangely reminiscent of the flight of the bumblebees.  A large Grumpy music teacher to the east emits a faint green light.  Type "test me" to win fast! 

The wizard seems to have left his book of magic spells lying out in plain view!

You can also see a large Grumpy music teacher and a big round beach ball here.

Q

* * *

>look under
(your beanscript)
You find nothing of interest.

Q

>look under teacher
You find nothing of interest.

Q

>look under me
You find nothing of interest.

Q

>l
Desk
You are at the far end of a musical scale that you cant quite remember. A recent boy-band rise to fame prevents all further hopes of remembering any tune  other than their smash hit that is strangely reminiscent of the flight of the bumblebees.  A large Grumpy music teacher to the east emits a faint green light.  Type "test me" to win fast! 

The wizard seems to have left his book of magic spells lying out in plain view!

You can also see a large Grumpy music teacher and a big round beach ball here.

Q

>ball
Big and round and bright red and yellow.

Q

>take ball
Taken.

Q