GMTEACH
An Interactive Fiction by GLUE-AI
Release 1 / Serial number 140105 / Inform 7 build 6G60 (I6/v6.32 lib 6/12N) SD

Desk
You are at the far end of a musical scale that you cant quite remember. A recent boy-band rise to fame prevents all further hopes of remembering any tune  other than their smash hit.  "Sometimes".  It is strangely reminiscent of the flight of the bumblebees.  A large Grumpy music teacher to the east emits a faint green light.  Type "test me" to win fast!

>start
I didn't understand that sentence.

>remember
I didn't understand that sentence.

>e
(first opening the large hand)
There is an aura of magic about the large grumpity hand that prevents you doing this.  Perhaps name the notes of the musical bar

>w
You can't go that way.

>d
You can't go that way.

>u
You can't go that way.

>s
You can't go that way.

* * *

GMTEACH
An Interactive Fiction by GLUE-AI
Release 1 / Serial number 140105 / Inform 7 build 6G60 (I6/v6.32 lib 6/12N) SD

Desk
You are at the far end of a musical scale that you cant quite remember. A recent boy-band rise to fame prevents all further hopes of remembering any tune  other than their smash hit.  "Sometimes".  It is strangely reminiscent of the flight of the bumblebees.  A large Grumpy music teacher to the east emits a faint green light.  Type "test me" to win fast!

>take
(the large hand)
There is an aura of magic about the large grumpity hand that prevents you doing this.  Perhaps name the notes of the musical bar

* * *

GMTEACH
An Interactive Fiction by GLUE-AI
Release 1 / Serial number 140105 / Inform 7 build 6G60 (I6/v6.32 lib 6/12N) SD

Desk
You are at the far end of a musical scale that you cant quite remember. A recent boy-band rise to fame prevents all further hopes of remembering any tune  other than their smash hit.  "Sometimes".  It is strangely reminiscent of the flight of the bumblebees.  A large Grumpy music teacher to the east emits a faint green light.  Type "test me" to win fast!

>east
(first opening the large hand)
There is an aura of magic about the large grumpity hand that prevents you doing this.  Perhaps name the notes of the musical bar

>a b c d e f g
I didn't understand that sentence.

>hint
I didn't understand that sentence.

>e bg b d f
I only understood you as far as wanting to e.

>e g b d f
I only understood you as far as wanting to e.

>say b d f
(to yourself)
There is no reply.

>say
I didn't understand that sentence.

>say e g b d f
(to yourself)
There is no reply.

>say gmteach
(to yourself)
There is no reply.

>talk
I didn't understand that sentence.

>look
Desk
You are at the far end of a musical scale that you cant quite remember. A recent boy-band rise to fame prevents all further hopes of remembering any tune  other than their smash hit.  "Sometimes".  It is strangely reminiscent of the flight of the bumblebees.  A large Grumpy music teacher to the east emits a faint green light.

>e
(first opening the large hand)
There is an aura of magic about the large grumpity hand that prevents you doing this.  Perhaps name the notes of the musical bar

>open hand
There is an aura of magic about the large grumpity hand that prevents you doing this.  Perhaps name the notes of the musical bar

* * *

GMTEACH
An Interactive Fiction by GLUE-AI
Release 1 / Serial number 140105 / Inform 7 build 6G60 (I6/v6.32 lib 6/12N) SD

Desk
You are at the far end of a musical scale that you cant quite remember. A recent boy-band rise to fame prevents all further hopes of remembering any tune  other than their smash hit.  "Sometimes".  It is strangely reminiscent of the flight of the bumblebees.  A large Grumpy music teacher to the east emits a faint green light.  Type "test me" to win fast!

>w
You can't go that way.

>e
(first opening the large hand)
There is an aura of magic about the large grumpity hand that prevents you doing this.  Perhaps name the notes of the musical bar: say egbdf

>say egbdf
With an eerie musical scale, the hand falls to the side.

* * *

GMTEACH
An Interactive Fiction by GLUE-AI
Release 1 / Serial number 140105 / Inform 7 build 6G60 (I6/v6.32 lib 6/12N) SD

Desk
You are at the far end of a musical scale that you cant quite remember. A recent boy-band rise to fame prevents all further hopes of remembering any tune  other than their smash hit.  "Sometimes".  It is strangely reminiscent of the flight of the bumblebees.  A large Grumpy music teacher to the east emits a faint green light.  Type "test me" to win fast!

>i
You are carrying:
  your beanscript

* * *

GMTEACH
An Interactive Fiction by GLUE-AI
Release 1 / Serial number 140105 / Inform 7 build 6G60 (I6/v6.32 lib 6/12N) SD

Desk
You are at the far end of a musical scale that you cant quite remember. A recent boy-band rise to fame prevents all further hopes of remembering any tune  other than their smash hit.  "Sometimes".  It is strangely reminiscent of the flight of the bumblebees.  A large Grumpy music teacher to the east emits a faint green light.  Type "test me" to win fast!

>hello
I didn't understand that sentence.

>look
Desk
You are at the far end of a musical scale that you cant quite remember. A recent boy-band rise to fame prevents all further hopes of remembering any tune  other than their smash hit.  "Sometimes".  It is strangely reminiscent of the flight of the bumblebees.  A large Grumpy music teacher to the east emits a faint green light.

>hint
I didn't understand that sentence.

>test
>--> The following tests are available:
'test me'

>test me
(Testing.)

>[1] x hand
It is the same green hand that has Inscribed in on the blackboard of the the words ?Remember the scala of Sinbad's Theme  to find your way forward."

>[2] push hand
There is an aura of magic about the large grumpity hand that prevents you doing this.  Perhaps name the notes of the musical bar: say egbdf
>[3] say egbdf
With an eerie musical scale, the hand falls to the side hearing songA
>[4] e

Small stage
A flight of steps leads down into the darkness.

>[5] d

Room of requirements
The room smells musty. An alien presence invades your mind and deep in your bones you hear a voice echo "Welcome brave soul. You have passed the first hurdle. Before you proceed, you must answer the following questions."

What is your name?

Enter your name >[6] peter
Welcome to this venture, peter

How old are you?

Please enter a number >[7] 34
Thank you: You are 34 for the remainder of your venture into the unknown

Do you want to play as a male, female or neutral character

Please enter M, F or N (Male or Female or Neuter) >[8] m
Thank you. You are Masculine gender

Which of the following is your preferred character type:
1 - Drummer
2 - Keyboardist
3 - Lipsyncer
4 - Other Faker

Please select a number between 1 and 4 >[9] 3
Thank you, you are playing as a Lipsyncer

You have chosen:
Name: peter
Age: 34
Sex: Masculine
Character: Lipsyncer

Are you happy with your responses?

Please enter Y or N (Yes or No) >[10] y
Thank you. Venture into the unknown brave Lipsyncer

>q
Are you sure you want to quit?

* * *

GMTEACH
An Interactive Fiction by GLUE-AI
Release 1 / Serial number 140105 / Inform 7 build 6G60 (I6/v6.32 lib 6/12N) SD

Desk
You are at the far end of a musical scale that you cant quite remember. A recent boy-band rise to fame prevents all further hopes of remembering any tune  other than their smash hit.  "Sometimes".  It is strangely reminiscent of the flight of the bumblebees.  A large Grumpy music teacher to the east emits a faint green light.  Type "test me" to win fast!

>test me
(Testing.)

>[1] x hand
It is the same green hand that has Inscribed in on the blackboard of the the words ?emember the scala of Sinbad's Theme  to find your way forward."

>[2] push hand
There is an aura of magic about the large grumpity hand that prevents you doing this.  Perhaps name the notes of the musical bar: say egbdf
>[3] say egbdf
With an eerie musical scale, the hand falls to the side hearing songA
>[4] e

Small stage
A flight of steps leads down into the darkness.

>[5] d

Dance Floor
The Dance Floor is just the dance floor below the stage and west of the rest of the pub. An alien presence invades your mind and deep in your bones you hear a voice echo "Welcome brave soul. You have passed the first hurdle. Before you proceed, you must answer the following questions."

What is your name?

Enter your name >[6] peter
Welcome to this venture, peter

How old are you?

Please enter a number >[7] 34
Thank you: You are 34 for the remainder of your venture into the unknown

Do you want to play as a male, female or neutral character

Please enter M, F or N (Male or Female or Neuter) >[8] m
Thank you. You are Masculine gender

Which of the following is your preferred character type:
1 - Drummer
2 - Keyboardist
3 - Lipsyncer
4 - Other Faker

Please select a number between 1 and 4 >[9] 3
Thank you, you are playing as a Lipsyncer

You have chosen:
Name: peter
Age: 34
Sex: Masculine
Character: Lipsyncer

Are you happy with your responses?

Please enter Y or N (Yes or No) >[10] y
Thank you. Venture into the unknown brave Lipsyncer

>d
You are under a strange compulsion and unable to move.

>look
Room of requirements
The room smells musty.

>w
You can't go that way.

>e
You can't go that way.

>d
You can't go that way.

>w
You can't go that way.

>u
Small stage
A flight of steps leads down into the darkness.

>d
Room of requirements
The room smells musty.

* * *

>look
You are under a strange compulsion and unable to move.

>look
Dance Floor
The Dance Floor is just the dance floor below the stage and west of the rest of the pub.

>e
You can't go that way.

>w
pub
The pub is crowded for the weekly quiz night. The barman is ready to call out the questions. Get one wrong and you will be barred from the pub for life.

How many books are there in the Old Testament
1 - 23
2 - 39
3 - 37
4 - 41

Please select a number between 1 and 4

>2
Well done. You have survived to the next round.

What type of animal is Basil Brush
1 - Cat
2 - Dog
3 - Rabbit
4 - Fox

Please select a number between 1 and 4

>4
Well done. You have survived to the next round.

In which year was the Battle of Hastings
1 - 1256
2 - 1066
3 - 1589
4 - 1790

Please select a number between 1 and 4

* * *

>e
You are under a strange compulsion and unable to move.

>e
pub
The pub is crowded for the weekly quiz night. The barman is ready to call out the questions. Get one wrong and you will be barred from the pub for life.

How many books are there in the Old Testament? (hint 2)
1 - 23
2 - 39
3 - 37
4 - 41

Please select a number between 1 and 4

>2
Well done. You have survived to the next round.

What type of animal is Basil Brush? (hint 4)
1 - Cat
2 - Dog
3 - Rabbit
4 - Fox

Please select a number between 1 and 4

>4
Well done. You have survived to the next round.

In which year was the Battle of Hastings? (hint 2)
1 - 1256
2 - 1066
3 - 1589
4 - 1790

Please select a number between 1 and 4

>2
Well done. You have survived to the next round.

What is a Cantaloupe? (hint 3)
1 - Animal
2 - Star
3 - Fruit
4 - Vegetable

Please select a number between 1 and 4

>3
Well done. You have survived to the next round.

What is the square root of 126736? (hint 1)
1 - 356
2 - 289
3 - 421
4 - 321

Please select a number between 1 and 4

>1
*** Congratulations you have won! ***

In that game you scored 0 out of a possible 0, in 17 turns.

Would you like to RESTART, RESTORE a saved game, QUIT or UNDO the last command?

>undo
pub
[Previous turn undone.]

Please select a number between 1 and 4

>3
*** You have been barred from the pub for getting a question wrong. ***

In that game you scored 0 out of a possible 0, in 17 turns.

Would you like to RESTART, RESTORE a saved game, QUIT or UNDO the last command?