Open Sesame Seed
An Interactive Fiction by GLUE-AI
Release 1 / Serial number 131216 / Inform 7 build 6G60 (I6/v6.32 lib 6/12N) SD

Desk
You are at the far end of a musical scale that you cant quite remember. A recent boy-band rise to fame prevents all further hopes of remembering any tune  other than their smash hit.  "Sometimes".  It is strangely reminiscent of the flight of the bumblebees.  A large Grumpy music teacher to the east emits a faint green light.

>start
I didn't understand that sentence.

>remember
I didn't understand that sentence.

>e
(first opening the large hand)
There is an aura of magic about the large grumpity hand that prevents you doing this.  Perhaps name the notes of the musical bar

>w
You can't go that way.

>d
You can't go that way.

>u
You can't go that way.

>s
You can't go that way.

* * *

Open Sesame Seed
An Interactive Fiction by GLUE-AI
Release 1 / Serial number 131216 / Inform 7 build 6G60 (I6/v6.32 lib 6/12N) SD

Desk
You are at the far end of a musical scale that you cant quite remember. A recent boy-band rise to fame prevents all further hopes of remembering any tune  other than their smash hit.  "Sometimes".  It is strangely reminiscent of the flight of the bumblebees.  A large Grumpy music teacher to the east emits a faint green light.

>take
(the large hand)
There is an aura of magic about the large grumpity hand that prevents you doing this.  Perhaps name the notes of the musical bar