It used to be said that there are two kinds of magic-user: those who have been to Tolti-Aph, and charlatans. It used to be generally understood that the attempt to prove oneself in the unforgiving society of Tolti-Aph was a bid for rapid level advancement or else romantic, thin-young-mage-in-midnight-black-robes death. The closer you get to the wilderness island vaguely marked "Tholtaff" on the agate globe in your great-great-grandfather's study, the better the alternative sounds: settling down in some coastal village, perhaps, a little weathermongering, some polymancy, and helping out with the nets after a bad storm. Retire at maybe level 3, with most of your experience points gained from observing rare fish-based poisons carry off those villagers careless about gutting. Publish an awesomely tedious monograph on the correct usage of the "untangle rigging" spell. You know, the good life.

The Reliques of Tolti-Aph
A W&W Scenario by Graham Nelson
Release 1 / Serial number 131216 / Inform 7 build 6G60 (I6/v6.32 lib 6/12N) SD

Longwall Street
Almost overgrown in the deep forest, collapsed and at once standing, the cyclopean east-west Longwall of the fallen city sinks here to a mostly flat, lichened stone clearing: it must once have been a customs post. To the west, an old wall turret like a broken chess piece still seems enterable by a dark doorway, whereas the eastern side of the wall's gap is only a shapeless ramp of masonry. Northwards, to what was once the interior, stubborn, wiry trees grapple with ancient pavings.

>n
Fallen Tree
The overgrown ground, sloping gradually downwards to the north, is interrupted here by the fallen trunk of a giant of a tree. The trunk seems to have partially demolished an old town-house to northeast.

Propped against the trunk in a parody of a sitting man, a skeleton - no, a woman's, to judge from the pelvis - shines white in the sunlight. The empty eye-sockets look up at the sky with a curious sort of expectancy.

On the skeleton's lap is a leather pack.

>e
If it were not for the break in the wall to northeast, you would only be able to go north or south along the lane.

>w
If it were not for the break in the wall to northeast, you would only be able to go north or south along the lane.

>n
Broken Lane
This must once have been a north-south thoroughfare, but now it is as cracked as a fishmonger's face. Even the old paving has given out, and its place is taken by stolen tombstones.

Set into the slab-sided western cutting of the lane is a flame-blackened door, no more than four feet high.

>n
Gravel Track
Even the makeshift paving gives out here, and the lane degenerates into a gravel track, rutted by carts and stamped all over with oddly inhuman prints of bare feet.

Vish, a goblin lookout armed with a spear, hisses in rage at the very sight of you desecrating his realm.

You attack Vish, stabbing the dagger, making an attack roll (1d20) of 6, +1 for your level - miss (3 to 10): no damage done!
Vish attacks you, lunging with the spear, making an attack roll (1d20) of 10 - miss (3 to 10): no damage done!

Jamming

>n
Just a warning before proceeding: you might want to exercise a little caution. It looks as if the lane may descend a little into shallow water, and if the goblin encampment has a centre, that will be it.

You attack Vish, stabbing the dagger, making an attack roll (1d20) of 5, +1 for your level - miss (3 to 10): no damage done!
Vish attacks you, lunging with the spear, making an attack roll (1d20) of 7 - miss (3 to 10): no damage done!

Jamming

>e
Though the humps around the lane - half-masonry, half-tree boles - must once have been public buildings, they are impenetrable now. Perhaps further on to the north.

You attack Vish, stabbing the dagger, making an attack roll (1d20) of 3, +1 for your level - miss (3 to 10): no damage done!
Vish attacks you, lunging with the spear, making an attack roll (1d20) of 16 - hit (11 to 19), doing 1d6 of damage: 1d6: 4 points: the leather jerkin absorbs 1, leaving 3 to take, reducing your strength to 11.

Jamming

>w
Though the humps around the lane - half-masonry, half-tree boles - must once have been public buildings, they are impenetrable now. Perhaps further on to the north.

You attack Vish, stabbing the dagger, making an attack roll (1d20) of 8, +1 for your level - miss (3 to 10): no damage done!
Vish attacks you, lunging with the spear, making an attack roll (1d20) of 6 - miss (3 to 10): no damage done!

Jamming

>w
Though the humps around the lane - half-masonry, half-tree boles - must once have been public buildings, they are impenetrable now. Perhaps further on to the north.

You attack Vish, stabbing the dagger, making an attack roll (1d20) of 6, +1 for your level - miss (3 to 10): no damage done!
Vish attacks you, lunging with the spear, making an attack roll (1d20) of 12 - hit (11 to 19), doing 1d6 of damage: 1d6: 1 point, reducing your strength to 10.

Jamming

>r
I didn't understand that sentence.

Jamming

>u
Though the humps around the lane - half-masonry, half-tree boles - must once have been public buildings, they are impenetrable now. Perhaps further on to the north.

You attack Vish, stabbing the dagger, making an attack roll (1d20) of 18, +1 for your level - hit (11 to 19), doing 1d3 of damage: 1d3: 3 points, wounding Vish to a strength of 2.
Vish attacks you, lunging with the spear, making an attack roll (1d20) of 20 - critical hit (20 or more), doing 1d6 doubled of damage: 1d6: 1, doubled up to 2 points: the leather jerkin absorbs 1, leaving 1 to take, reducing your strength to 9.

Jamming

>q
Are you sure you want to quit?

>n
Jamming

>exit
But you aren't in anything at the moment.

You attack Vish, stabbing the dagger, making an attack roll (1d20) of 2, +1 for your level - miss (3 to 10): no damage done!
Vish attacks you, lunging with the spear, making an attack roll (1d20) of 12 - hit (11 to 19), doing 1d6 of damage: 1d6: 2 points: the leather jerkin absorbs 1, leaving 1 to take, reducing your strength to 8.

Jamming

>peace
I didn't understand that sentence.

Jamming

>help
(This game is being run according to the rules of a simplified role-playing game which we will call Woodpulp & Wyverns, or W&W. The protagonist is a magic-user, whose main ability is to cast spells. We are not in search of riches but of experience: by collecting experience points, the protagonist may progress upwards in "level": the SCORE command shows this. An INVENTORY (or I) lists the spells known as well as the items carried.

One's strength, STR, is drained both by casting spells and by being wounded, and - especially early on - it is important to husband this carefully: but the means of restoration can also be found. It will probably take several games to work out the best tactics of play. Tolti-Aph is not a safe place, so expect to be killed every now and again (i.e. with terrifying frequency - E.S.).

W&W play differs from conventional interactive fiction in that there is a great deal of randomised behaviour. Notations like 4d6+2 express the (virtual) dice rolls to be made: this one would involve rolling 4 six-sided dice, then adding 2 to the result. Jamming is an especially unpredictable business, but note that one can often run away from a fight which is going badly.

It is possible to get yourself into some insanely hard fights, or to run risks of appalling strength loss, where you might get lucky, but will die nine times out of ten. This is almost always a sign that you've missed something. The designer intends that a sufficiently ingenious player of IF can win through with even the worst luck. Still, with life and death hanging on the roll of a die, the UNDO command has been withdrawn. SAVE is allowed, but an important early puzzle is to work out how to do it.

Lastly, this is one of the worked examples whose source text is included in full in the documentation for Inform 7, a system to create interactive fiction. About the first quarter lays out general rules for W&W play, and can be borrowed to write new W&W scenarios.)

Jamming

>play
Your singing is abominable.

You attack Vish, stabbing the dagger, making an attack roll (1d20) of 10, +1 for your level - hit (11 to 19), doing 1d3 of damage: 1d3: 1 point, wounding Vish to a strength of 1.
Vish attacks you, lunging with the spear, making an attack roll (1d20) of 3 - miss (3 to 10): no damage done!

Jamming

>hit
What do you want to hit?

Jamming

* * *

>n
Fallen Tree
The overgrown ground, sloping gradually downwards to the north, is interrupted here by the fallen trunk of a giant of a tree. The trunk seems to have partially demolished an old town-house to northeast.

Propped against the trunk in a parody of a sitting man, a skeleton - no, a woman's, to judge from the pelvis - shines white in the sunlight. The empty eye-sockets look up at the sky with a curious sort of expectancy.

On the skeleton's lap is a leather pack.

>n
Broken Lane
This must once have been a north-south thoroughfare, but now it is as cracked as a fishmonger's face. Even the old paving has given out, and its place is taken by stolen tombstones.

Set into the slab-sided western cutting of the lane is a flame-blackened door, no more than four feet high.

>n
Gravel Track
Even the makeshift paving gives out here, and the lane degenerates into a gravel track, rutted by carts and stamped all over with oddly inhuman prints of bare feet.

Vish, a guitar lookout armed with a fastLick, hisses in rage at the very sight of you desecrating his realm.

You attack Vish, stabbing the dagger, making an attack roll (1d20) of 6, +1 for your level - miss (3 to 10): no damage done!
Vish attacks you, lunging with the fastLick, making an attack roll (1d20) of 10 - miss (3 to 10): no damage done!

performance

* * *

>e
It is a long, steep climb up the ragged eastern side of the Longwall breach, and costs you 1 strength point.

Stone Mound
The remains of the Longwall rise steeply up eastward of the curious ruined platform, and also lose their shape, becoming little more than a great stone mound. Here at the top, it looks as if the stonework has been shattered by lightning and not just slow old time, but that seems an unreal idea when the canopies of the forest stretch out in every direction against a clear autumnal-blue sky.

A barbed metallic feather, from a bird which must have been scaly and very large - also, disconcertingly, metallic - lies in the loose rubble.

>e
The only safe way down the Mound is back to westward.

>w
Longwall Street
Almost overgrown in the deep forest, collapsed and at once standing, the cyclopean east-west Longwall of the fallen city sinks here to a mostly flat, lichened stone clearing: it must once have been a customs post. To the west, an old wall turret like a broken chess piece still seems enterable by a dark doorway, whereas the eastern side of the wall's gap is only a shapeless ramp of masonry. Northwards, to what was once the interior, stubborn, wiry trees grapple with ancient pavings.

>w
Your passage through the doorway triggers off an old trap, of rusty blades swung across by a counterweight! A crude, one-time device, but this doesn't seem the time to sneer at its naive simplicity. You just know there was something you could have done to avoid this... You soak up 4d4: 2,2,1,3=8 points of damage: the leather jerkin absorbs 1, leaving 7 to take, reducing your strength to 6.

Turret Roundhouse
This broad round chamber forms the central well of the turret. Little light enters by the dark doorway from the east, but the crude steps upward presumably lead to a lookout.

An old trestle table is scattered with a few crumbs, suggesting that somebody has lived here quite recently.

Propped against one wall, almost as if it was meant for you to find it, is a battered scroll.

>u
Turret Alcove
The rough steps - probably not the original construction - end at a blank-walled alcove, bare except for a medicine chest.

A little light shows through a broad arrowslit in the northwestern wall of the turret, which is where the steps have wound around to.

>u
You can't go that way.

>fight
What do you want to fight?

>jam
You can't see any such thing.

>jam with
I didn't understand that sentence.

>comvat
I didn't understand that sentence.

>combat
I didn't understand that sentence.

>fight
What do you want to fight?

>look
Turret Alcove
The rough steps - probably not the original construction - end at a blank-walled alcove, bare except for a medicine chest.

A little light shows through a broad arrowslit in the northwestern wall of the turret, which is where the steps have wound around to.

>nw
You can't go that way.

>n
You can't go that way.

>w
You can't go that way.

>e
You can't go that way.

>d
Turret Roundhouse
This broad round chamber forms the central well of the turret. Little light enters by the dark doorway from the east, but the crude steps upward presumably lead to a lookout.

An old trestle table is scattered with a few crumbs, suggesting that somebody has lived here quite recently.

Propped against one wall, almost as if it was meant for you to find it, is a battered scroll.

>d
You can't go that way.

>take scroll
Taken.

>look
Turret Roundhouse
This broad round chamber forms the central well of the turret. Little light enters by the dark doorway from the east, but the crude steps upward presumably lead to a lookout.

An old trestle table is scattered with a few crumbs, suggesting that somebody has lived here quite recently.

>get crumbs
They're too small and fiddly.

>e
Longwall Street
Almost overgrown in the deep forest, collapsed and at once standing, the cyclopean east-west Longwall of the fallen city sinks here to a mostly flat, lichened stone clearing: it must once have been a customs post. To the west, an old wall turret like a broken chess piece still seems enterable by a dark doorway, whereas the eastern side of the wall's gap is only a shapeless ramp of masonry. Northwards, to what was once the interior, stubborn, wiry trees grapple with ancient pavings.

>e
It is a long, steep climb up the ragged eastern side of the Longwall breach, and costs you 1 strength point.

Stone Mound
The remains of the Longwall rise steeply up eastward of the curious ruined platform, and also lose their shape, becoming little more than a great stone mound. Here at the top, it looks as if the stonework has been shattered by lightning and not just slow old time, but that seems an unreal idea when the canopies of the forest stretch out in every direction against a clear autumnal-blue sky.

A barbed metallic feather, from a bird which must have been scaly and very large - also, disconcertingly, metallic - lies in the loose rubble.

* * *

>e
The only safe way down the Mound is back to westward.

>e
The only safe way down the Mound is back to westward.

* * *

>w
Longwall Street
Almost overgrown in the deep forest, collapsed and at once standing, the cyclopean east-west Longwall of the fallen city sinks here to a mostly flat, lichened stone clearing: it must once have been a customs post. To the west, an old wall turret like a broken chess piece still seems enterable by a dark doorway, whereas the eastern side of the wall's gap is only a shapeless ramp of masonry. Northwards, to what was once the interior, stubborn, wiry trees grapple with ancient pavings.

>n
Fallen Tree
The overgrown ground, sloping gradually downwards to the north, is interrupted here by the fallen trunk of a giant of a tree. The trunk seems to have partially demolished an old town-house to northeast.

Propped against the trunk in a parody of a sitting man, a skeleton - no, a woman's, to judge from the pelvis - shines white in the sunlight. The empty eye-sockets look up at the sky with a curious sort of expectancy.

On the skeleton's lap is a leather pack.

* * *

>n
Broken Lane
This must once have been a north-south thoroughfare, but now it is as cracked as a fishmonger's face. Even the old paving has given out, and its place is taken by stolen tombstones.

Set into the slab-sided western cutting of the lane is a flame-blackened door, no more than four feet high.

>n
Gravel Track
Even the makeshift paving gives out here, and the lane degenerates into a gravel track, rutted by carts and stamped all over with oddly inhuman prints of bare feet.

Vish, a goblin lookout armed with a spear, hisses in rage at the very sight of you desecrating his realm.

You attack Vish, stabbing the keyboard, making an attack roll (1d20) of 3, +1 for your level - miss (3 to 10): no damage done!
Vish attacks you, lunging with the spear, making an attack roll (1d20) of 16 - hit (11 to 19), doing 1d6 of damage: 1d6: 4 points: the leather jerkin absorbs 1, leaving 3 to take, reducing your strength to 2.

Jamming